黑石头站->高井站
高井站->福寿岭站
福寿岭站->苹果园站
苹果园站->古城站,杨庄站,金安桥站
古城站->衙门口站
衙门口站->八角游乐园站
八角游乐园站->八宝山站
八宝山站->玉泉路站
玉泉路站->五棵松站
五棵松站->万寿路站
万寿路站->公主坟站
公主坟站->军事博物馆站,西钓鱼台站
军事博物馆站->木樨地站,白堆子站
木樨地站->南礼士路站,玉渊潭东门站
南礼士路站->复兴门站
复兴门站->西单站,阜成门站
西单站->天安门西站,灵境胡同站
天安门西站->天安门东站
天安门东站->王府井站
王府井站->东单站,前门站,前门站
东单站->建国门站,灯市口站
建国门站->永安里站,北京站
永安里站->国贸站
国贸站->大望路站,双井站
大望路站->四惠站,北京地铁20号线,北京地铁20号线
四惠站->四惠东站,四惠东站
四惠东站->高碑店站,高碑店站
高碑店站->传媒大学站,传媒大学站
传媒大学站->双桥站,双桥站
双桥站->管庄站,管庄站
管庄站->八里桥站,八里桥站
八里桥站->通州北苑站,通州北苑站
通州北苑站->果园站,果园站
果园站->九棵树站,九棵树站
九棵树站->梨园站,梨园站
梨园站->临河里站,临河里站
临河里站->土桥站,土桥站
土桥站->花庄站,北京地铁7号线
西直门站->积水潭站,动物园站
积水潭站->鼓楼大街站
鼓楼大街站->安定门站,什刹海站,什刹海站
安定门站->雍和宫站
雍和宫站->东直门站,和平里北街站
东直门站->东四十条站
东四十条站->朝阳门站
朝阳门站->建国门站,东大桥站
北京站->崇文门站
崇文门站->前门站,东单站
前门站->和平门站,珠市口站,珠市口站
和平门站->中南海
中南海->人民大会堂
人民大会堂->宣武门站
宣武门站->长椿街站,西单站
长椿街站->复兴门站
阜成门站->车公庄站
车公庄站->西直门站,平安里站
公益西桥站->角门西站
角门西站->马家堡站,草桥站
马家堡站->北京南站
北京南站->陶然亭站,陶然桥站,陶然桥站
陶然亭站->菜市口站
菜市口站->宣武门站,虎坊桥站
灵境胡同站->西四站
西四站->平安里站
平安里站->新街口站,北海北站
新街口站->西直门站
动物园站->国家图书馆站
国家图书馆站->魏公村站,万寿寺站
魏公村站->人民大学站
人民大学站->海淀黄庄站
海淀黄庄站->中关村站,知春里站
中关村站->北京大学东门站
北京大学东门站->圆明园站
圆明园站->西苑站
西苑站->北宫门站,农大南路站
北宫门站->安河桥北站
宋家庄站->刘家窑站,石榴庄站,肖村站
刘家窑站->蒲黄榆站
蒲黄榆站->天坛东门站,方庄站,方庄站
天坛东门站->磁器口站
磁器口站->崇文门站,广渠门内站
灯市口站->东四站
东四站->张自忠路站,朝阳门站
张自忠路站->北新桥站
北新桥站->雍和宫站
和平里北街站->和平西桥站
和平西桥站->惠新西街南口站
惠新西街南口站->惠新西街北口站,芍药居站
惠新西街北口站->大屯路东站
大屯路东站->北苑路北站,关庄站
北苑路北站->立水桥南站
立水桥南站->立水桥站
立水桥站->天通苑南站,北苑站
天通苑南站->天通苑站
天通苑站->天通苑北站
天通苑北站->小汤山
小汤山->平西府站
平西府站->平坊站,回龙观东大街站,回龙观东大街站
平坊站->马坊站
金安桥站->苹果园站,四道桥站
杨庄站->西黄村站
西黄村站->廖公庄站
廖公庄站->田村站
田村站->海淀五路居站
海淀五路居站->慈寿寺站
慈寿寺站->花园桥站,车道沟站
花园桥站->白石桥南站
白石桥南站->二里沟站,国家图书馆站
二里沟站->车公庄西站,国家图书馆站
车公庄西站->车公庄站
北海北站->南锣鼓巷站
南锣鼓巷站->东四站,中国美术馆站,中国美术馆站
东大桥站->呼家楼站
呼家楼站->金台路站,金台夕照站
金台路站->十里堡站,朝阳公园站,朝阳公园站
十里堡站->青年路站
青年路站->褡裢坡站
褡裢坡站->黄渠站
黄渠站->常营站
常营站->草房站
草房站->物资学院路站
物资学院路站->通州北关站
通州北关站->通运门站
通运门站->北运河西站
北运河西站->北运河东站
北运河东站->郝家府站
郝家府站->东夏园站
东夏园站->潞城站
北京西站->湾子站,军事博物馆站
湾子站->达官营站
达官营站->广安门内站,木樨地站
广安门内站->菜市口站
虎坊桥站->珠市口站
珠市口站->桥湾站,天桥站,天桥站
桥湾站->磁器口站
广渠门内站->广渠门外站
广渠门外站->双井站
双井站->九龙山站,劲松站
九龙山站->大郊亭站,大望路站,大望路站
大郊亭站->百子湾站
百子湾站->化工站
化工站->南楼梓庄站
南楼梓庄站->欢乐谷景区站
欢乐谷景区站->垡头站
垡头站->双合站
双合站->焦化厂站
焦化厂站->黄厂村站
黄厂村站->豆各庄站
豆各庄站->黑庄户站
黑庄户站->万盛南街西口站
万盛南街西口站->云景东路站
云景东路站->小马庄站
小马庄站->高楼金站
高楼金站->北京地铁1号线
北京地铁1号线->环球影城站
朱辛庄站->育知路站,育知路站,巩华城站
育知路站->平西府站,平西府站
回龙观东大街站->霍营站,霍营站
霍营站->育新站,育新站,立水桥站
育新站->西小口站,西小口站
西小口站->永泰庄站,永泰庄站
永泰庄站->林萃桥站,林萃桥站
林萃桥站->森林公园南门站,森林公园南门站
森林公园南门站->奥林匹克公园站,奥林匹克公园站
奥林匹克公园站->奥体中心站,奥体中心站,安立路站
奥体中心站->北土城站,北土城站
北土城站->安华桥站,安华桥站,安贞门站
安华桥站->安德里北街站,安德里北街站
安德里北街站->鼓楼大街站,鼓楼大街站
什刹海站->南锣鼓巷站,南锣鼓巷站
中国美术馆站->金鱼胡同站,金鱼胡同站
金鱼胡同站->王府井站,王府井站
天桥站->永定门外站,永定门外站
永定门外站->木樨园站,木樨园站,景泰站,景泰站
木樨园站->海户屯站,海户屯站
海户屯站->大红门站,大红门站
大红门站->大红门南站,大红门南站,角门东站
大红门南站->和义站,和义站
和义站->东高地站,东高地站
东高地站->火箭万源站,火箭万源站
火箭万源站->五福堂站,五福堂站
五福堂站->德茂站,德茂站
德茂站->瀛海站,瀛海站
郭公庄站->丰台科技园站,首经贸站
丰台科技园站->科怡路站
科怡路站->丰台南路站
丰台南路站->丰台东大街站,丰台站
丰台东大街站->七里庄站
七里庄站->六里桥站,西局站,西局站
六里桥站->六里桥东站,莲花桥站
六里桥东站->北京西站
白堆子站->白石桥南站
巴沟站->苏州街站
苏州街站->海淀黄庄站,万泉河桥站
知春里站->知春路站
知春路站->西土城站,五道口站
西土城站->牡丹园站
牡丹园站->健德门站
健德门站->北土城站
安贞门站->惠新西街南口站
芍药居站->太阳宫站,光熙门站
太阳宫站->三元桥站
三元桥站->亮马桥站
亮马桥站->农业展览馆站
农业展览馆站->团结湖站
团结湖站->呼家楼站
金台夕照站->国贸站
劲松站->潘家园站
潘家园站->十里河站
十里河站->分钟寺站,北工大西门站,北工大西门站
分钟寺站->成寿寺站
成寿寺站->宋家庄站
石榴庄站->大红门站
角门东站->角门西站
草桥站->纪家庙站
纪家庙站->首经贸站
首经贸站->丰台站,丰益桥南站
丰台站->泥洼站,丰益桥南站
泥洼站->西局站
西局站->六里桥站,东管头站,东管头站
莲花桥站->公主坟站
西钓鱼台站->慈寿寺站
车道沟站->长春桥站
长春桥站->火器营站
火器营站->巴沟站
大钟寺站->大钟寺站,知春路站
五道口站->上地站
上地站->西二旗站
西二旗站->回龙观站,生命科学园站
回龙观站->霍营站
北苑站->望京西站
望京西站->芍药居站,望京站
光熙门站->柳芳站
柳芳站->东直门站
园博园站->大瓦窑站,大瓦窑站
大瓦窑站->郭庄子站,郭庄子站
郭庄子站->大井站,大井站
大井站->七里庄站,七里庄站
东管头站->丽泽商务区站,丽泽商务区站
丽泽商务区站->菜户营站,菜户营站,红莲南里站
菜户营站->西铁营站,西铁营站
西铁营站->景风门站,景风门站
景风门站->北京南站,北京南站
陶然桥站->永定门外站,永定门外站
景泰站->蒲黄榆站,蒲黄榆站
方庄站->十里河站,十里河站
北工大西门站->平乐园站,平乐园站
平乐园站->九龙山站,九龙山站
北京地铁20号线->金台路站,金台路站
朝阳公园站->枣营站,枣营站
枣营站->东风北桥站,东风北桥站
东风北桥站->将台站,将台站
将台站->高家园站,高家园站
高家园站->望京南站,望京南站
望京南站->阜通站,阜通站
阜通站->望京站,望京站
望京站->东湖渠站,东湖渠站,望京东站
东湖渠站->来广营站,来广营站
来广营站->善各庄站,善各庄站
清华东路西口站->六道口站
六道口站->北沙滩站
北沙滩站->奥林匹克公园站
安立路站->大屯路东站
关庄站->望京西站
望京东站->崔各庄站
崔各庄站->马泉营站
马泉营站->孙河站
孙河站->国展站
国展站->花梨坎站
花梨坎站->后沙峪站
后沙峪站->南法信站
南法信站->石门站
石门站->顺义站
顺义站->俸伯站
看丹站->富丰桥站
富丰桥站->丰台南路站
丰益桥南站->丽泽商务区站
红莲南里站->达官营站
玉渊潭东门站->甘家口站
甘家口站->二里沟站
万寿寺站->苏州桥站
苏州桥站->苏州街站
万泉河桥站->西苑站
农大南路站->马连洼站
马连洼站->西北旺站
西北旺站->永丰南站
永丰南站->永丰站
永丰站->屯佃站
屯佃站->稻香湖路站
稻香湖路站->温阳路站
温阳路站->北安河站
北京地铁7号线->环球影城站
生命科学园站->朱辛庄站
巩华城站->沙河站
沙河站->沙河高教园站
沙河高教园站->南邵站
南邵站->北邵洼站
北邵洼站->昌平东关站
昌平东关站->昌平站
昌平站->十三陵景区站
十三陵景区站->昌平西山口站
肖村站->小红门站
小红门站->旧宫站
旧宫站->亦庄桥站
亦庄桥站->亦庄文化园站
亦庄文化园站->万源街站
万源街站->荣京东街站
荣京东街站->荣昌东街站
荣昌东街站->同济南路站
同济南路站->经海路站
经海路站->次渠南站
次渠南站->次渠站
次渠站->亦庄火车站
阎村东站->苏庄站
苏庄站->良乡南关站
良乡南关站->良乡大学城西站
良乡大学城西站->良乡大学城站
良乡大学城站->良乡大学城北站
良乡大学城北站->广阳城站
广阳城站->篱笆房站
篱笆房站->长阳站
长阳站->稻田站
稻田站->大葆台站
大葆台站->郭公庄站
四道桥站->桥户营站
桥户营站->上岸站
上岸站->栗园庄站
栗园庄站->小园站
小园站->石厂站
紫草坞站->阎村站
阎村站->星城站
星城站->大石河东站
大石河东站->马各庄站
马各庄站->饶乐府站
饶乐府站->房山城关站
房山城关站->燕山站
燕山站->老城区站
老城区站->顾册站
